HALAL	Accipitrimorphae
HALLE	Accipitrimorphae
CATAU	Accipitrimorphae
GAVST	Loon
BUCRH	Bucerotiformes
CAPCA	Caprimulgimorphae
CARCR	Cariamiformes
CHAVO	Charadriiformes
COLST	Coliiformes
COLLI	Columbiformes
CUCCA	Cuculiformes
EURHE	Eurypygiformes
FALPE	Falconiformes
GALGA	Galloanseres
MELGA	Galloanseres
ANAPL	Galloanseres
BALRE	Gruiformes
LEPDI	Leptosomiformes
MESUN	Mesitornithirormes
TAUER	Musophagiformes
OPHHO	Opisthocomiformes
CORBR	Passeriformes
GEOFO	Passeriformes
TAEGU	Passeriformes
MANVI	Passeriformes
CHLUN	Otidiformes
STRCA	Paleognathae
TINMA	Paleognathae
ACACH	Passeriformes
EGRGA	Pelecanimorphae
NIPNI	Pelecanimorphae
PELCR	Pelecanimorphae
PHACA	Pelecanimorphae
PHALE	Phaethontimorphae
PHORU	Phoenicopterimorphae
PODCR	Phoenicopterimorphae
MERNU	Piciformes/Coraciiformes
PICPU	Piciformes/Coraciiformes
FULGL	Procellariimorphae
MELUN	Psittaciformes
NESNO	Psittaciformes
PTEGU	Pterocliformes
APTFO	Sphenisciformes
PYGAD	Sphenisciformes
TYTAL	Strigiformes
APAVI	Trogoniformes
CALAN	Trochili
CHAPE	Trochili
